15 10
..#.#.#......$.
..##.......$...
#.#.#..$.....@.
#..$.#....#....
#..##...@......
#......$.$..#..
.$....$........
........$$#...X
.#..$..........
...##..$$..$$..